{
  "bijoy": {
    "mappings": {
      "0": "০",
      "1": "১",
      "2": "২",
      "3": "৩",
      "4": "৪",
      "5": "৫",
      "6": "৬",
      "7": "৭",
      "8": "৮",
      "9": "৯",
      "a": "ৃ",
      "A": "র্",
      "d": "ি",
      "D": "ী",
      "s": "ু",
      "S": "ূ",
      "f": "া",
      "F": "অ",
      "g": "্",
      "G": "।",
      "h": "ব",
      "H": "ভ",
      "j": "ক",
      "J": "খ",
      "k": "ত",
      "K": "থ",
      "l": "দ",
      "L": "ধ",
      "z": "্র",
      "Z": "্য",
      "x": "ও",
      "X": "ৗ",
      "c": "ে",
      "C": "ৈ",
      "v": "র",
      "V": "ল",
      "b": "ন",
      "B": "ণ",
      "n": "স",
      "N": "ষ",
      "m": "ম",
      "M": "শ",
      "q": "ঙ",
      "Q": "ং",
      "w": "য",
      "W": "য়",
      "e": "ড",
      "E": "ঢ",
      "r": "প",
      "R": "ফ",
      "t": "ট",
      "T": "ঠ",
      "y": "চ",
      "Y": "ছ",
      "u": "জ",
      "U": "ঝ",
      "i": "হ",
      "I": "ঞ",
      "o": "গ",
      "O": "ঘ",
      "p": "ড়",
      "P": "ঢ়",
      "&": "ঁ",
      "$": "৳",
      "`": "\u200C",
      "~": "\u200D",
      "\\": "ৎ",
      "|": "ঃ"
    }
  },
  "somewherein_phonetic": {
    "mappings": {
      "0": "০",
      "1": "১",
      "2": "২",
      "3": "৩",
      "4": "৪",
      "5": "৫",
      "6": "৬",
      "7": "৭",
      "8": "৮",
      "9": "৯",
      "a": "া",
      "A": "আ",
      "d": "ড",
      "D": "দ",
      "s": "স",
      "S": "ষ",
      "f": "ফ",
      "F": "ঋ",
      "g": "গ",
      "G": "ঘ",
      "h": "হ",
      "H": "ঃ",
      "j": "জ",
      "J": "ঝ",
      "k": "ক",
      "K": "খ",
      "l": "ল",
      "L": "খ",
      "z": "য",
      "Z": "ত"
    }
  }
}
